1111111111111111111111
111111110111P111111111
1000100000000000000001
1000100000000000000001
1000100000000000000001
11111110011E1111CC1111
1111111111111111111111