1111111111111111111111
111000010111P000000001
1000100001010000000001
1000100000000000000001
1000100000000000000001
11000010011E1111CC1111
1111111111111111111111